1 1 1 1 1 1 1 1 1 1 1 1 1
1 18 0 13 6 7 6 0 0 0 0 0 1
1 1 1 1 1 1 1 1 1 1 1 0 1
1 16 0 10 3 0 1 16 13 16 1 0 1
1 13 10 17 1 0 1 16 13 16 1 0 1
1 1 3 1 1 0 1 1 1 11 1 0 1
1 13 10 0 1 0 3 9 6 8 1 0 1
1 17 0 14 1 0 1 1 1 1 1 0 1
1 1 3 1 1 0 0 0 0 0 0 0 1
1 0 10 0 1 1 5 1 1 1 3 1 1
1 16 16 13 1 15 0 0 1 13 10 14 1
1 16 0 13 1 0 19 0 1 13 13 13 1
1 1 1 1 1 1 1 1 1 1 1 1 1