1 1 1 1 1 1 1 1 1 1 1 1 1 
1 19 1 0 10 0 1 0 0 13 15 1 1  
1 0 1 17 1 16 1 0 0 13 14 1 1  
1 0 1 13 1 13 1 0 0 13 10 1 1  
1 0 1 13 1 13 1 1 1 1 3 1 1  
1 0 1 0 1 0 0 0 3 0 0 1 1  
1 0 1 3 1 1 3 1 1 3 1 1 1  
1 0 5 0 0 0 0 1 0 10 0 1 1  
1 0 1 3 1 1 4 1 3 1 3 1 1  
1 0 1 13 1 16 17 1 0 1 0 1 1  
1 0 1 13 1 16 16 1 0 1 0 1 1  
1 18 1 17 1 17 16 1 0 1 0 1 1  
1 1 1 1 1 1 1 1 1 1 1 1 1