1 1 1 1 1 1 1 1 1 1 1 1 1 
1 20 7 13 1 0 21 0 1 1 1 1 1 
1 7 13 0 1 0 0 0 1 0 8 0 1 
1 13 10 0 1 1 3 1 1 0 1 0 1 
1 1 3 1 1 1 0 10 1 13 1 7 1 
1 0 0 0 1 1 1 0 1 13 1 8 1 
1 6 1 0 8 7 8 0 1 13 1 7 1 
1 6 1 1 1 1 1 0 0 0 1 0 1 
1 0 0 0 0 0 1 1 3 1 1 0 1 
1 1 1 1 1 8 1 7 0 7 1 0 1 
1 1 0 0 0 0 1 17 8 13 1 0 1 
1 19 0 1 1 1 1 0 0 0 1 0 1 
1 1 1 1 1 1 1 1 1 1 1 1 1